0 0 0 1 0 0 0 100 100 0 0   
0 0 64 1 1 0 0 100 100 0 0   
0 0 128 1 1 0 0 100 100 0 0   
0 0 192 1 1 0 0 100 100 0 0   
0 0 256 1 1 0 0 100 100 0 0   
0 0 320 1 1 0 0 100 100 0 0   
0 0 384 1 1 0 0 100 100 0 0   
0 0 448 1 1 0 0 100 100 0 0   
0 0 512 1 1 0 0 100 100 0 0   
0 0 576 1 1 0 0 100 100 0 0   
0 0 640 1 1 0 0 100 100 0 0   
0 0 704 1 1 0 0 100 100 0 0   
0 0 768 1 1 0 0 100 100 0 0   
0 0 832 1 1 0 0 100 100 0 0   
0 0 896 1 1 0 0 100 100 0 0   
0 0 960 1 1 0 0 100 100 0 0   
0 0 1024 1 1 0 0 100 100 0 0   
0 0 1088 1 1 0 0 100 100 0 0   
3 0 1152 1 0 0 0 100 100 0 0   
3 0 1216 1 0 0 0 100 100 0 0   
3 0 1280 1 0 0 0 100 100 0 0   
3 0 1344 1 0 0 0 100 100 0 0   
3 0 1408 1 0 0 0 100 100 0 0   
3 64 1472 1 0 0 0 100 100 0 0   
3 128 1472 1 0 0 0 100 100 0 0   
3 192 1472 1 0 0 0 100 100 0 0   
3 256 1472 1 0 0 0 100 100 0 0   
3 320 1472 1 0 0 0 100 100 0 0   
3 384 1472 1 0 0 0 100 100 0 0   
3 512 1472 1 0 0 0 100 100 0 0   
3 448 1472 1 0 0 0 100 100 0 0   
3 576 1472 1 0 0 0 100 100 0 0   
3 640 1472 1 0 0 0 100 100 0 0   
3 704 1472 1 0 0 0 100 100 0 0   
3 768 1472 1 0 0 0 100 100 0 0   
3 832 1472 1 0 0 0 100 100 0 0   
3 896 1472 1 0 0 0 100 100 0 0   
3 960 1472 1 0 0 0 100 100 0 0   
3 1024 1472 1 0 0 0 100 100 0 0   
3 1024 1408 1 0 0 0 100 100 0 0   
3 960 1408 1 0 0 0 100 100 0 0   
3 896 1408 1 0 0 0 100 100 0 0   
3 832 1408 1 0 0 0 100 100 0 0   
3 768 1408 1 0 0 0 100 100 0 0   
3 704 1408 1 0 0 0 100 100 0 0   
3 640 1408 1 0 0 0 100 100 0 0   
3 576 1408 1 0 0 0 100 100 0 0   
3 512 1408 1 0 0 0 100 100 0 0   
3 448 1408 1 0 0 0 100 100 0 0   
3 384 1408 1 0 0 0 100 100 0 0   
3 320 1408 1 0 0 0 100 100 0 0   
3 256 1408 1 0 0 0 100 100 0 0   
3 192 1408 1 0 0 0 100 100 0 0   
3 128 1408 1 0 0 0 100 100 0 0   
3 64 1408 1 0 0 0 100 100 0 0   
3 64 1344 1 0 0 0 100 100 0 0   
3 64 1280 1 0 0 0 100 100 0 0   
3 128 1344 1 0 0 0 100 100 0 0   
3 192 1344 1 0 0 0 100 100 0 0   
4 64 1216 0 0 0 0 100 100 0 0   
4 128 1280 0 0 0 0 100 100 0 0   
5 128 1216 0 0 0 0 100 100 0 0   
4 192 1280 0 0 0 0 100 100 0 0   
5 192 1216 0 0 0 0 100 100 0 0   
3 192 1216 1 0 0 0 100 100 0 0   
4 256 1280 0 0 0 0 100 100 0 0   
3 256 1344 1 0 0 0 100 100 0 0   
3 384 1344 1 0 0 0 100 100 0 0   
4 0 1472 0 0 0 0 100 100 0 0   
3 320 1344 1 0 0 0 100 100 0 0   
4 320 1280 0 0 0 0 100 100 0 0   
4 384 1280 0 0 0 0 100 100 0 0   
3 256 1216 1 0 0 0 100 100 0 0   
5 320 1216 0 0 0 0 100 100 0 0   
5 320 1152 0 0 0 0 100 100 0 0   
5 384 1216 0 0 0 0 100 100 0 0   
5 384 1152 0 0 0 0 100 100 0 0   
5 128 1152 0 0 0 0 100 100 0 0   
5 64 1152 0 0 0 0 100 100 0 0   
5 128 1088 0 0 0 0 100 100 0 0   
5 64 1088 0 0 0 0 100 100 0 0   
5 128 1024 0 0 0 0 100 100 0 0   
1 64 960 0 0 0 0 100 100 0 0   
1 128 960 0 0 0 0 100 100 0 0   
1 320 960 0 0 0 0 100 100 0 0   
1 384 960 0 0 0 0 100 100 0 0   
1 384 1024 0 0 0 0 100 100 0 0   
0 448 1152 1 1 0 0 100 100 0 0   
0 448 1216 1 1 0 0 100 100 0 0   
0 448 1280 1 1 0 0 100 100 0 0   
0 448 1344 1 1 0 0 100 100 0 0   
0 512 1344 1 1 0 0 100 100 0 0   
0 576 1344 1 1 0 0 100 100 0 0   
0 640 1344 1 1 0 0 100 100 0 0   
0 704 1344 1 1 0 0 100 100 0 0   
0 768 1344 1 1 0 0 100 100 0 0   
0 832 1344 1 1 0 0 100 100 0 0   
0 960 1344 1 1 0 0 100 100 0 0   
0 896 1344 1 1 0 0 100 100 0 0   
0 1024 1344 1 1 0 0 100 100 0 0   
0 1088 1344 1 1 0 0 100 100 0 0   
0 1088 1408 1 1 0 0 100 100 0 0   
0 1088 1472 1 1 0 0 100 100 0 0   
0 256 960 1 1 0 0 100 100 0 0   
0 256 1024 1 1 0 0 100 100 0 0   
0 256 1088 1 1 0 0 100 100 0 0   
0 256 1152 1 1 0 0 100 100 0 0   
0 192 1152 1 1 0 0 100 100 0 0   
1 128 896 0 0 0 0 100 100 0 0   
1 320 896 0 0 0 0 100 100 0 0   
1 384 896 0 0 0 0 100 100 0 0   
1 64 832 0 0 0 0 100 100 0 0   
1 128 832 0 0 0 0 100 100 0 0   
1 192 832 0 0 0 0 100 100 0 0   
1 320 832 0 0 0 0 100 100 0 0   
1 384 832 0 0 0 0 100 100 0 0   
1 448 1024 0 0 0 0 100 100 0 0   
1 448 960 0 0 0 0 100 100 0 0   
1 448 896 0 0 0 0 100 100 0 0   
1 448 832 0 0 0 0 100 100 0 0   
1 64 768 0 0 0 0 100 100 0 0   
1 192 768 0 0 0 0 100 100 0 0   
1 384 768 0 0 0 0 100 100 0 0   
1 448 768 0 0 0 0 100 100 0 0   
1 64 704 0 0 0 0 100 100 0 0   
1 128 704 0 0 0 0 100 100 0 0   
1 192 704 0 0 0 0 100 100 0 0   
1 384 704 0 0 0 0 100 100 0 0   
1 448 704 0 0 0 0 100 100 0 0   
5 192 896 0 0 0 0 100 100 0 0   
5 128 768 0 0 0 0 100 100 0 0   
6 192 1024 0 1 0 0 100 100 0 0   
6 192 1088 0 1 0 0 100 100 0 0   
6 64 1024 0 1 0 0 100 100 0 0   
6 64 896 0 1 0 0 100 100 0 0   
2 192 960 0 0 0 0 100 100 0 0   
3 256 896 1 0 0 0 100 100 0 0   
3 256 832 1 0 0 0 100 100 0 0   
3 256 768 1 0 0 0 100 100 0 0   
3 256 704 1 0 0 0 100 100 0 0   
3 320 768 1 0 0 0 100 100 0 0   
3 320 704 1 0 0 0 100 100 0 0   
3 256 640 1 0 0 0 100 100 0 0   
3 320 640 1 0 0 0 100 100 0 0   
3 384 640 1 0 0 0 100 100 0 0   
3 320 576 1 0 0 0 100 100 0 0   
3 384 576 1 0 0 0 100 100 0 0   
3 384 512 1 0 0 0 100 100 0 0   
3 448 576 1 0 0 0 100 100 0 0   
3 448 512 1 0 0 0 100 100 0 0   
3 448 448 1 0 0 0 100 100 0 0   
3 384 448 1 0 0 0 100 100 0 0   
3 448 384 1 0 0 0 100 100 0 0   
3 512 448 1 0 0 0 100 100 0 0   
3 512 512 1 0 0 0 100 100 0 0   
3 576 448 1 0 0 0 100 100 0 0   
3 512 384 1 0 0 0 100 100 0 0   
3 576 384 1 0 0 0 100 100 0 0   
3 640 448 1 0 0 0 100 100 0 0   
3 640 512 1 0 0 0 100 100 0 0   
3 704 384 1 0 0 0 100 100 0 0   
3 640 384 1 0 0 0 100 100 0 0   
3 704 448 1 0 0 0 100 100 0 0   
3 768 512 1 0 0 0 100 100 0 0   
3 704 512 1 0 0 0 100 100 0 0   
3 768 448 1 0 0 0 100 100 0 0   
3 768 384 1 0 0 0 100 100 0 0   
3 832 448 1 0 0 0 100 100 0 0   
3 832 512 1 0 0 0 100 100 0 0   
3 832 576 1 0 0 0 100 100 0 0   
3 768 576 1 0 0 0 100 100 0 0   
3 896 512 1 0 0 0 100 100 0 0   
3 896 576 1 0 0 0 100 100 0 0   
3 896 640 1 0 0 0 100 100 0 0   
3 960 640 1 0 0 0 100 100 0 0   
3 960 576 1 0 0 0 100 100 0 0   
0 448 320 1 1 0 0 100 100 0 0   
0 512 320 1 1 0 0 100 100 0 0   
0 576 320 1 1 0 0 100 100 0 0   
0 640 320 1 1 0 0 100 100 0 0   
0 704 320 1 1 0 0 100 100 0 0   
0 768 320 1 1 0 0 100 100 0 0   
0 448 256 1 1 0 0 100 100 0 0   
0 448 192 1 1 0 0 100 100 0 0   
0 448 128 1 1 0 0 100 100 0 0   
0 448 64 1 1 0 0 100 100 0 0   
0 448 0 1 0 0 0 100 100 0 0   
0 384 0 1 0 0 0 100 100 0 0   
0 320 0 1 0 0 0 100 100 0 0   
0 256 0 1 0 0 0 100 100 0 0   
0 192 0 1 0 0 0 100 100 0 0   
0 128 0 1 0 0 0 100 100 0 0   
0 64 0 1 0 0 0 100 100 0 0   
1 192 640 0 0 0 0 100 100 0 0   
1 128 640 0 0 0 0 100 100 0 0   
1 64 640 0 0 0 0 100 100 0 0   
1 64 576 0 0 0 0 100 100 0 0   
1 128 576 0 0 0 0 100 100 0 0   
1 192 576 0 0 0 0 100 100 0 0   
1 256 576 0 0 0 0 100 100 0 0   
1 320 512 0 0 0 0 100 100 0 0   
1 256 512 0 0 0 0 100 100 0 0   
1 192 512 0 0 0 0 100 100 0 0   
1 64 512 0 0 0 0 100 100 0 0   
1 128 512 0 0 0 0 100 100 0 0   
1 64 448 0 0 0 0 100 100 0 0   
1 128 448 0 0 0 0 100 100 0 0   
1 192 448 0 0 0 0 100 100 0 0   
1 256 448 0 0 0 0 100 100 0 0   
1 320 448 0 0 0 0 100 100 0 0   
1 320 384 0 0 0 0 100 100 0 0   
1 384 384 0 0 0 0 100 100 0 0   
1 256 384 0 0 0 0 100 100 0 0   
1 192 384 0 0 0 0 100 100 0 0   
1 128 384 0 0 0 0 100 100 0 0   
1 64 384 0 0 0 0 100 100 0 0   
1 64 320 0 0 0 0 100 100 0 0   
1 128 320 0 0 0 0 100 100 0 0   
1 192 320 0 0 0 0 100 100 0 0   
1 256 320 0 0 0 0 100 100 0 0   
1 320 320 0 0 0 0 100 100 0 0   
1 384 320 0 0 0 0 100 100 0 0   
1 384 256 0 0 0 0 100 100 0 0   
1 320 256 0 0 0 0 100 100 0 0   
1 256 256 0 0 0 0 100 100 0 0   
1 192 256 0 0 0 0 100 100 0 0   
1 128 256 0 0 0 0 100 100 0 0   
1 64 256 0 0 0 0 100 100 0 0   
1 64 192 0 0 0 0 100 100 0 0   
1 128 192 0 0 0 0 100 100 0 0   
1 192 192 0 0 0 0 100 100 0 0   
1 256 192 0 0 0 0 100 100 0 0   
1 320 192 0 0 0 0 100 100 0 0   
1 384 192 0 0 0 0 100 100 0 0   
1 384 128 0 0 0 0 100 100 0 0   
1 384 64 0 0 0 0 100 100 0 0   
1 320 128 0 0 0 0 100 100 0 0   
1 320 64 0 0 0 0 100 100 0 0   
1 256 128 0 0 0 0 100 100 0 0   
1 256 64 0 0 0 0 100 100 0 0   
1 192 128 0 0 0 0 100 100 0 0   
1 192 64 0 0 0 0 100 100 0 0   
1 128 128 0 0 0 0 100 100 0 0   
1 128 64 0 0 0 0 100 100 0 0   
1 64 128 0 0 0 0 100 100 0 0   
1 64 64 0 0 0 0 100 100 0 0   
1 512 576 0 0 0 0 100 100 0 0   
1 448 640 0 0 0 0 100 100 0 0   
1 512 640 0 0 0 0 100 100 0 0   
1 576 576 0 0 0 0 100 100 0 0   
1 640 576 0 0 0 0 100 100 0 0   
1 704 576 0 0 0 0 100 100 0 0   
1 704 640 0 0 0 0 100 100 0 0   
1 768 640 0 0 0 0 100 100 0 0   
1 832 640 0 0 0 0 100 100 0 0   
1 896 704 0 0 0 0 100 100 0 0   
1 960 704 0 0 0 0 100 100 0 0   
1 832 704 0 0 0 0 100 100 0 0   
1 704 704 0 0 0 0 100 100 0 0   
1 768 704 0 0 0 0 100 100 0 0   
1 640 640 0 0 0 0 100 100 0 0   
1 576 640 0 0 0 0 100 100 0 0   
1 640 704 0 0 0 0 100 100 0 0   
1 576 704 0 0 0 0 100 100 0 0   
1 512 704 0 0 0 0 100 100 0 0   
1 512 768 0 0 0 0 100 100 0 0   
1 576 768 0 0 0 0 100 100 0 0   
1 512 832 0 0 0 0 100 100 0 0   
1 576 832 0 0 0 0 100 100 0 0   
1 512 896 0 0 0 0 100 100 0 0   
1 576 896 0 0 0 0 100 100 0 0   
1 512 960 0 0 0 0 100 100 0 0   
1 576 960 0 0 0 0 100 100 0 0   
1 512 1024 0 0 0 0 100 100 0 0   
1 576 1024 0 0 0 0 100 100 0 0   
1 512 1088 0 0 0 0 100 100 0 0   
1 576 1088 0 0 0 0 100 100 0 0   
1 512 1152 0 0 0 0 100 100 0 0   
1 576 1152 0 0 0 0 100 100 0 0   
1 512 1216 0 0 0 0 100 100 0 0   
1 576 1216 0 0 0 0 100 100 0 0   
1 512 1280 0 0 0 0 100 100 0 0   
1 576 1280 0 0 0 0 100 100 0 0   
0 448 1088 1 1 0 0 100 100 0 0   
0 384 1088 1 1 0 0 100 100 0 0   
5 320 1088 0 0 0 0 100 100 0 0   
1 320 1024 0 0 0 0 100 100 0 0   
2 576 512 0 0 0 0 100 100 0 0   
box 1152 1536   
